******************************
*         *                  *
* ******* * **************   *
* *   S * * *            *   *
* * *** * * * ********** *   *
* * * * * * *        *   *   *
* * * * * * ******** *   *   *
* * * * * * *      * *   *   *
* * * * * * * **** * *   *   *
* * * * * * * *  * * *   *   *
* * * * * * * * ** * *   *   *
* * * * * * * *    * *   *   *
* * * * * * ******** *   *   *
* * * * * *          *   *   *
* * * * **************   *   *
* * * *                  *   *
* * ********************* *  *
* *                     * *  *
* ********************* * *  *
*                     * * *  *
*************** ***** * * *  *
*             *     *   * *  *
* *********** ***** *** * *  *
* *                 *   * *  *
* * ***************** *** *  *
*                   *    E*  *
******************************
