*********
*      S*
* *******
*       *
******* *
*       *
* *******
*       *
*******E*