*********
*S      *
*       *
*       *
*       *
*       *
*       *
*       *
*******E*