*********
*       *
***  ****
* *S*   *
* * *   *
* * *   *
* * *****
*       *
*******E*