*********
*S      *
* * *****
* *     *
* * **  *
* *  *  *
* ****  *
*       *
*******E*